******************
*         *   E  *
*    *    ****** *
*    ******    * *
*    *    *      *
*         *    ***
*S   *         *
****************